1111111111111111
1111111111111111
1000000000000001
1C110C0111000001
1E00000P00000001
1111111111111111
